*E***************************************************************************************************
*                                             *   *     *         *     *     *   *         *       *
* ***** * ***************** ********* ***** * * *** *** * ***** * * ***** *** * * * * ******* ***** *
*     * *                 *       *   *     *   *   * *   *     * *     *   *   *   * *       *   * *
* *** *** *** *********** * ***** * *** ********* *** ***** ******* *** *** ********* * ********* * *
*   *   *   *           * * *   * * *   *       *     *   *       *   *   * *       * *   * *   * * *
*** *** *** ************* * *** * * * *** * ******* *** * ***** * * ***** * * *** *** *** * * * * * *
* *   * *   *   *         *   * * * *     * *       *   *     * *   *     * *   *       * *   * * * *
* ***** * *** * * ***** ***** * * * ******* * ******* ******* ******* *** * *** ********* ***** * * *
*       * * * * *     * *     *   * *   *   * *   *   *   *       *   *   *   *   *     *     * *   *
*** ***** * * * *** * * * ********* * * * *** * * * *** * ******* * * * *** * *** ***** ***** * * ***
*   *     *   *   * * * *         * * * *   *   * * *   * *     *   * * *   * *   *     *   *   * * *
* * ******* ***** *** * ***** * *** *** *** ***** * * *** * *** * ***** * *** * *** *** *** ***** * *
* *   *   *     * *   *     * * *   *     *   *   *   *   *   * * *     *   * *   * * *       * *   *
* *** * * ***** *** ******* *** * * * ***** * * ******* ******* *** ********* *** * * * ***** * *** *
*   * * *     * *   *       *   * * * *     * *     * * *     *     *       *   *   *   *           *
* * * * ***** * * *** * ***** *** * * ************* * * * *** ******* ***** *** ********* ********* *
* * * *     *     *   * *       * * *     *   *     *   * * *   *   *   *   * *         *   *   * * *
* * * *********** * ***** ***** * ******* * * *** ******* * * *** * * * ***** ********* ***** * * * *
* * *   *   *     * *   * *     *       * * *   *   *       *     *   *       * *   * *     * *   * *
*** * *** * *** *** * * *** ********* * * * *** *** * *** ******* ********* *** * * * *** * * ***** *
*   *   * *   *   *   * *   *       * * * *   * *   * * * *     * *   *     *   * * *   * * * *   * *
* ***** ***** * * ***** * *** *** * * * * *** *** *** * * * * * * * *** *** * * *** *** * * * * * * *
*     *     * * *   *   *   * * * * * * *     *   *     *   * * * *     *   * *         * *   * * * *
***** *** * * ***** * ***** * * * *** *** ***** *** ********* * ************* ***************** * * *
*   *   * * *       * *   * * * *   * *       *   *   *   *   *         *     * *       *   *   *   *
* ******* * ********* *** * * * * * * * ***** *** *** * * * * ********* * ***** * ***** * *** *******
* *       * *             * * * * * *   *   *     * * * * * *     *   * *       *   *   *   * *     *
* * * ***** *************** * * * * ******* ******* * * *** ***** * * * ******* *** * ***** * * *****
* * * *   *         *   * *     * *                 * *   *     * * * * *     *   * *       * *     *
* * * * * ********* * * * ******* * ***** *********** *** * *** * * * * * *** *** * ********* ***** *
*   * * *         *   * * *   * * *     *         *   *   * *   * * * *   * *     *       *       * *
***** * ******* * ***** * * * * * ******* ******* * *** ***** *** * * ***** ************* ***** *** *
*     *   * *   *     *   * * *   *           * *   *   *     *   * * *         *       *     *     *
* ******* * * ******* ******* ***** ***** *** * ***** ***** * * *** *** *** *** * *** ******* * *****
*     *   * *       *   *     *     *       *   *   *     * * *   *   *   * *   *   * *       * *   *
***** * *** * * *** * * * *** * *** ************* * ***** * * *** *** * *** ********* * ******* * * *
*   *     * * * * * * *     * *   *         * *   *     * * * *   *   * *   *         * *       * * *
* * ***** * * * * * * ***** * *** * * ***** * * * ***** * * *** *** *** * * * ********* * ******* ***
* *     *   * * *   * *   * * * * * *     * *   * * *   * *   *     * * * * *           *   *   *   *
* ***** ******* *** * * * * * * * ******* * * *** * * *** *** ******* * * ************* *** *** *** *
*     *     *     * *   * * * * *     * * * * * * *   *               * *       *       * * *   *   *
***** ***** * * * ******* * * * * *** * * *** * * ********************* *** *** * ******* * * * * * *
*     *   *   * *     * * * * * *   * * *     *   *       *               * *   *     *   * * *   * *
* *** * * *** * ***** * * * * * *** * * *** ******* *** * * *************** * ******* * *** * ***** *
*   * * * *   *   * * * * * *   *   * *   *           * * *             *   * * *   * *   *   *   * *
* * * * * ******* * * * * * ********* *** *********** * * ***** ******* * *** * * * * *** ***** * * *
* * * * * *       *   * * * *   *   *       *     *   * *       *     * * *   * * * *   *   *   * * *
* * * * * * *********** * *** * * * ********* *** * ************* *** *** * *** * * *** *** * *** * *
* * * * *   *           *     *   *   *     * * * * *   *   *     *   *   *     * *         *   * * *
* * * * ********* ******************* * *** * * * * * * * * ******* *** ********* ************* * * *
* * * *     *             *   *     * * *   * *   *   * * * *     * *       *   *   *           *   *
* * ******* * *********** * * * *** * * * ***** *** *** * * * * *** * *** * * * *** * ***************
* * *     *   *     *     * * * * * *   *         *   *   *   * *   * *   * * *       *     *       *
* * * * ***** * *** ******* *** * * ************* ************* * *** * ***** ********* *** * ***** *
* *   *     * * * * *     *   * * *     *   *   * *       *   * * * * * *     *   *   *   *   *   * *
* ******* * *** * * * *** * * * * *** * * * *** * * ***** * *** * * * * * ***** * * * *** ***** * * *
* * *     *       *   * * * * *     * * * *     * *   * * *   * *   * * * *   * *   *   *   *   * * *
* * * ***************** * * * ***** * * * ******* *** * * *** * *** * * * * * ********* ***** *** * *
* * * *                 *   *     * * * *       *   * * *     *     * * *   *           *   * * * * *
* * * ***** ************* ******* * * * ******* * *** * ************* * *************** * * * * * * *
*   *     *         *   * *     *   * * *   *   *       *     *     * *     *     *     * * * *   * *
* *** * *** ******* *** * ***** * * * * * * * *********** *** * *** * * * *** *** * *** *** * ***** *
*   * *     *   *   *   * *     * * * * * * * *     *   *   * * * * * * *       *     *     *   *   *
*** * * * *** * ***** *** * ***** * * *** * * ***** * * ***** * * * * ******* * * *** ********* * ***
* * * * *   * *     *   *   *   * * *   * * * *     * *       *   * *       * * *   *     *   * *   *
* * * * *** * ***** *** * *** * * * *** *** * * ***** *********** * ******* *** *** ***** * * * *** *
*   * *   * *     *     *   * * * *   *       *                   *   *   *   *   *   *   * * *     *
***** * *** ******* ******* * * * *** ***** *** ***** *************** * ***** *** *** * *** * ***** *
*   * * *   *         *   *   * *   * *   * *       *       *     *   *   *   * *   * *     *       *
* * * * * *** ******* *** ***** *** * * * *** ******* ******* *** * ***** * *** * * * ***************
* * * * *       *   *   *     * *   *   *       *   *         *   *     * * * *   * *   *     *     *
* *** * ******* * * *** *** * *** * ******* *** * * *********** ********* * * ********* * *** * *****
*     *       *   * *   *   *   * *       * *   * *   *       *   *     *   * *       * *   * *     *
******* ***** ***** ***** ***** * ******* * ***** *** ******* *** * *** ***** * * ***** ***** ***** *
*     *     * *     *   * *       *     * *   * * *   *     *   *   * *     *   *     *     *     * *
* *** ***** * ******* * * ***** * * ***** *** * * * *** * * *** *** * * * * * ******* ***** * ***** *
*   *   *   * *   *   * * *   * * * *     *   *   *     * *   *   *   * * *   *     *     *         *
*** *** * *** * * * ***** * * * * * * * ******* ********* ******* ***** * * *** ***** * *************
* * *   * *   * *   *     * *   * *   * *               *       * *   * * *   * *   * *     *     * *
* * ***** * *** ******* *** ***** ******* ************* ***** *** * * * * ***** * * ***** * * * * * *
*         *   *   *     *   *     *     *   * *     * * *   *   * * *   *     *   *       *   * * * *
*********** * *** * * *** ******* ***** *** * * *** * * *** * * * * ********* *********** ***** * * *
*         * * *   * *   *       *         * * *   * * * *   * *   *   *       *         *   *   * * *
* ******* *** * ******* *** *** ********* * * *** * * * * *** ******* * ***** * ******* ***** * * * *
* *   *   *   * *         * *   *       * *   *   *   *     *   *   * *   *   *   *   *   *   * *   *
* *** * *** *** * ******* * * *** ***** ***** * *** *********** * *** *** * ***** * ***** * * * *****
*   * * *   *     *   *   * *         * *     * *   *   *       *   *   * * *     * *     * * * *   *
* * * * * * * ******* * ***** ******* * * ***** * *** * * * ******* * * * *** ***** * ***** *** *** *
* * *   * * *   *     *     * *     * * *     * * *   * * * *         * *   *   *     * *   *   *   *
* * *** *** ***** ********* *** *** * * ***** *** * *** * *** ********* *** ***** *** * * * * *** ***
* *   *     *     * *   *   *   * * * *       *   * * *   *   *   *   *   *         * *   * *       *
* * * ******* ***** * * * * * *** * ******* *** *** * ***** *** *** ***** * * ***** ******* *********
* * *               * *   * *     *       *   * * * * *   * * *   *     * * * *   * *   *   *       *
* ***** * *********** ******************* *** * * * * * *** * *** ***** * * * * * *** * * *** *** * *
* *   * *   *   *                       *   *   * *   * *   * *           * *   *   * * *   * * * * *
* * * * *** * * ***** ******* ***** ***** ***** * ***** * *** ******* * * * ******* * * ***** * * ***
*   * *   *   *     *   *   *     * *   * *   * *     * *   * *   *   * * *   *     * * *     * *   *
***** *** ******* * *** *** ***** * * * * * * ******* * *** * * * ***** * *** ******* * * ***** *** *
*     *   *       *   *     *     *   *     *         *     *   *       *   *         *       *     *
***************************************************************************************************X*
